<com.google.ads.internal.AdVideoView: void c()>	Permission:android.permission.WAKE_LOCK
<com.millennialmedia.android.MMAdViewSDK: boolean isConnected(android.content.Context)>	Permission:android.permission.ACCESS_NETWORK_STATE
<com.millennialmedia.android.VideoView: void start()>	Permission:android.permission.WAKE_LOCK
<com.google.ads.internal.AdVideoView: void b()>	Permission:android.permission.WAKE_LOCK
<com.millennialmedia.android.AdViewOverlayView:  com.millennialmedia.android.AdViewOverlayView(android.app.Activity,com.millennialmedia.android.OverlaySettings)>	Permission:android.permission.INTERNET
<com.millennialmedia.android.AdCache: boolean downloadComponent(java.lang.String,java.lang.String,java.io.File)>	Permission:android.permission.INTERNET
<com.millennialmedia.android.MMMedia$Audio: com.millennialmedia.android.MMJSResponse stop()>	Permission:android.permission.WAKE_LOCK
<com.google.ads.ae: java.net.HttpURLConnection a(java.net.URL)throwsjava.io.IOException>	Permission:android.permission.INTERNET
<com.millennialmedia.android.MMMedia$Audio$1: void onCompletion(android.media.MediaPlayer)>	Permission:android.permission.WAKE_LOCK
<com.google.ads.internal.AdWebView: public com.google.ads.internal.AdWebView(com.google.ads.n,com.google.ads.AdSize)>	Permission:android.permission.INTERNET
<com.google.ads.ae: void run()>	Permission:android.permission.INTERNET
<com.millennialmedia.android.MMFileManager: com.millennialmedia.android.MMJSResponse downloadFile(java.util.HashMap<java.lang.String,java.lang.String>)>	Permission:android.permission.INTERNET
<com.google.ads.internal.AdVideoView: void d()>	Permission:android.permission.WAKE_LOCK
<com.millennialmedia.android.VideoView: void pause()>	Permission:android.permission.WAKE_LOCK
<com.millennialmedia.android.AdViewOverlayView$OverlayJSInterface: void shouldVibrate(long)>	Permission:android.permission.WAKE_LOCK
<com.ifeel.frogjump.AudioPlayer: void playMainBG()>	Permission:android.permission.WAKE_LOCK
<com.google.ads.internal.AdVideoView: void e()>	Permission:android.permission.WAKE_LOCK
<com.millennialmedia.android.MMAdViewController$MMJSInterface: void vibrate(int)>	Permission:android.permission.WAKE_LOCK
<com.google.ads.util.AdUtil: java.lang.String i(android.content.Context)>	Permission:android.permission.INTERNET
<com.millennialmedia.android.MMAdViewSDK: java.lang.String getAuid(android.content.Context)>	Permission:android.permission.READ_PHONE_STATE
<com.millennialmedia.android.HttpRedirection: java.lang.String navigateRedirects(java.lang.String)>	Permission:android.permission.INTERNET
<com.ifeel.frogjump.AudioPlayer: void release()>	Permission:android.permission.WAKE_LOCK
<com.google.ads.internal.f$1: java.net.HttpURLConnection a(java.net.URL)throwsjava.io.IOException>	Permission:android.permission.INTERNET
<com.millennialmedia.android.MMAdViewSDK: java.lang.String getConnectionType(android.content.Context)>	Permission:android.permission.ACCESS_NETWORK_STATE
<com.millennialmedia.android.VideoView: void stopPlayback()>	Permission:android.permission.WAKE_LOCK
<com.google.ads.util.AdUtil: java.lang.String d(android.content.Context)>	Permission:android.permission.ACCESS_NETWORK_STATE
<com.google.ads.internal.j: java.net.HttpURLConnection a(java.net.URL)throwsjava.io.IOException>	Permission:android.permission.INTERNET
<com.millennialmedia.android.MMMedia$Audio: com.millennialmedia.android.MMJSResponse playAudio(android.net.Uri,boolean)>	Permission:android.permission.WAKE_LOCK
<com.millennialmedia.android.VideoPlayerActivity$VideoServer: public com.millennialmedia.android.VideoPlayerActivity$VideoServer(com.millennialmedia.android.VideoPlayerActivity,android.content.Context,java.lang.String)>	Permission:android.permission.INTERNET
<com.millennialmedia.android.MMNotification: com.millennialmedia.android.MMJSResponse vibrate(java.util.HashMap<java.lang.String,java.lang.String>)>	Permission:android.permission.WAKE_LOCK
<com.ifeel.frogjump.AudioPlayer: void stopMainBG()>	Permission:android.permission.WAKE_LOCK
<com.millennialmedia.android.MMAdView: public com.millennialmedia.android.MMAdView(android.content.Context,android.util.AttributeSet,int)>	Permission:android.permission.INTERNET
