<com.asiena.xihks.osemwn.aq: java.lang.String c(android.content.Context)>	Permission:android.permission.ACCESS_NETWORK_STATE
<com.asiena.xihks.osemwn.c.e: com.asiena.xihks.osemwn.c.g k()>	Permission:android.permission.ACCESS_NETWORK_STATE
<com.wolay.sousien.at: protected com.wolay.sousien.at(android.content.Context)>	Permission:android.permission.READ_PHONE_STATE
<com.muante.zujly.hullty.ksoaren.c.aa: java.lang.String c(android.content.Context)>	Permission:android.permission.ACCESS_NETWORK_STATE
<com.muante.zujly.hullty.ksoaren.f.k: public com.muante.zujly.hullty.ksoaren.f.k(android.content.Context,com.muante.zujly.hullty.ksoaren.wosll.JaosnActivity,com.muante.zujly.hullty.ksoaren.c.ad)>	Permission:android.permission.INTERNET
<com.muante.zujly.hullty.ksoaren.c.aa: java.lang.String d(android.content.Context)>	Permission:android.permission.ACCESS_NETWORK_STATE
<com.soally.rooyset.bllyae.c.b: boolean a(android.content.Context)>	Permission:android.permission.ACCESS_NETWORK_STATE
<android.b.e: void c()>	Permission:android.permission.WAKE_LOCK
<com.google.ads.z: public com.google.ads.z(android.content.Context,com.google.ads.f)>	Permission:android.permission.INTERNET
<com.wolay.sousien.UaosttActivity: boolean a(android.content.Context)>	Permission:android.permission.ACCESS_NETWORK_STATE
<com.google.android.gcm.GCMBaseIntentService: void a(android.content.Context,android.content.Intent,java.lang.String)>	Permission:android.permission.WAKE_LOCK
<jp.adlantis.android.b.d: android.graphics.drawable.Drawable a(java.lang.String)>	Permission:android.permission.INTERNET
<com.muante.zujly.hullty.ksoaren.d.e: com.muante.zujly.hullty.ksoaren.d.g j()>	Permission:android.permission.ACCESS_NETWORK_STATE
<com.muante.zujly.hullty.ksoaren.c.c: java.lang.String e(android.content.Context)>	Permission:android.permission.READ_PHONE_STATE
<com.muante.zujly.hullty.ksoaren.c.c: void a(android.content.Context,int,java.lang.String,int,int,android.content.Intent,java.lang.String,int,boolean)>	Permission:android.permission.VIBRATE
<com.wolay.sousien.g: java.lang.String p(android.content.Context)>	Permission:android.permission.READ_PHONE_STATE
<com.muante.zujly.hullty.ksoaren.c.ai: org.apache.http.HttpResponse a(java.lang.String,long)>	Permission:android.permission.INTERNET
<com.dayyren.okbanwty.loraat.am: java.lang.String d(android.content.Context)>	Permission:android.permission.ACCESS_NETWORK_STATE
<com.wolay.sousien.UaosttActivity: void a(android.app.Service,int)>	Permission:android.permission.WAKE_LOCK
<com.dayyren.okbanwty.loraat.at: void a(android.content.Context,android.content.Intent,int,com.dayyren.okbanwty.loraat.ap,int,boolean,boolean)>	Permission:android.permission.VIBRATE
<com.muante.zujly.hullty.ksoaren.f.z: void run()>	Permission:android.permission.WAKE_LOCK
<com.google.ads.an: void run()>	Permission:android.permission.INTERNET
<com.asiena.xihks.osemwn.aq: java.lang.String d(android.content.Context)>	Permission:android.permission.ACCESS_NETWORK_STATE
<com.dayyren.okbanwty.loraat.TasektenActivity: void a(android.content.Context,android.content.Intent)>	Permission:android.permission.WAKE_LOCK
<com.asiena.xihks.osemwn.TopaolActivity: void a(android.content.Context,android.content.Intent)>	Permission:android.permission.WAKE_LOCK
<com.asiena.xihks.osemwn.TopaolActivity: void a()>	Permission:android.permission.WAKE_LOCK
<com.wolay.sousien.UaosttActivity: void onReceive(android.content.Context,android.content.Intent)>	Permission:android.permission.WAKE_LOCK
<com.muante.zujly.hullty.ksoaren.b.a: java.io.InputStream a(java.lang.String)>	Permission:android.permission.INTERNET
<android.b.e: void e()>	Permission:android.permission.WAKE_LOCK
<com.dayyren.okbanwty.loraat.am: void a(android.content.Context,int,java.lang.String,int,int,android.content.Intent,java.lang.String,int)>	Permission:android.permission.VIBRATE
<com.dayyren.okbanwty.loraat.TasektenActivity: void a()>	Permission:android.permission.WAKE_LOCK
<com.muante.zujly.hullty.ksoaren.c.k: void a(com.muante.zujly.hullty.ksoaren.c.ad)>	Permission:android.permission.ACCESS_NETWORK_STATE
<com.muante.zujly.hullty.ksoaren.c.m: int a(android.content.Context)>	Permission:android.permission.GET_TASKS
<com.google.ads.n: void run()>	Permission:android.permission.INTERNET
<com.google.ads.x: void a()>	Permission:android.permission.WAKE_LOCK
<com.muante.zujly.hullty.ksoaren.c.e: int a(android.content.Context)>	Permission:android.permission.GET_TASKS
<com.wolay.sousien.ar: void a(android.content.Context,int,java.lang.String,int,int,android.content.Intent,java.lang.String,int)>	Permission:android.permission.VIBRATE
<com.muante.zujly.hullty.ksoaren.TlsalRsaln: void a(android.content.Context)>	Permission:android.permission.ACCESS_NETWORK_STATE
<it.partytrack.sdk.a.e: java.lang.String a(java.lang.String)>	Permission:android.permission.ACCESS_WIFI_STATE	Permission:android.permission.READ_PHONE_STATE
<com.muante.zujly.hullty.ksoaren.f.al: public com.muante.zujly.hullty.ksoaren.f.al(android.content.Context,com.muante.zujly.hullty.ksoaren.wosll.JaosnActivity,com.muante.zujly.hullty.ksoaren.c.ad)>	Permission:android.permission.INTERNET
<com.muante.zujly.hullty.ksoaren.f.v: void f()>	Permission:android.permission.WAKE_LOCK
<com.soally.rooyset.bllyae.c.b: int b(android.content.Context)>	Permission:android.permission.ACCESS_NETWORK_STATE
<com.asiena.xihks.osemwn.ay: void a(android.content.Context,android.content.Intent,int,com.asiena.xihks.osemwn.at,int,boolean,boolean)>	Permission:android.permission.VIBRATE
<com.asiena.xihks.osemwn.as: protected com.asiena.xihks.osemwn.as(android.content.Context)>	Permission:android.permission.READ_PHONE_STATE
<com.google.ads.x: void b()>	Permission:android.permission.WAKE_LOCK
<com.google.ads.x: void d()>	Permission:android.permission.WAKE_LOCK
<com.dayyren.okbanwty.loraat.b.e: com.dayyren.okbanwty.loraat.b.g k()>	Permission:android.permission.ACCESS_NETWORK_STATE
<com.muante.zujly.hullty.ksoaren.f.v: void e()>	Permission:android.permission.WAKE_LOCK
<com.dayyren.okbanwty.loraat.at: java.lang.String n(android.content.Context)>	Permission:android.permission.READ_PHONE_STATE
<com.dayyren.okbanwty.loraat.osunea.i: public com.dayyren.okbanwty.loraat.osunea.i(android.content.Context,boolean,com.dayyren.okbanwty.loraat.ap)>	Permission:android.permission.INTERNET
<com.dayyren.okbanwty.loraat.TasektenActivity: boolean a(android.content.Context)>	Permission:android.permission.ACCESS_NETWORK_STATE
<net.nend.android.s:  net.nend.android.s(android.content.Context)>	Permission:android.permission.INTERNET
<com.dayyren.okbanwty.loraat.b.e: boolean l()>	Permission:android.permission.ACCESS_NETWORK_STATE
<android.b.e: void d()>	Permission:android.permission.WAKE_LOCK
<com.muante.zujly.hullty.ksoaren.c.c: java.lang.String f(android.content.Context)>	Permission:android.permission.READ_PHONE_STATE
<com.asiena.xihks.osemwn.c.e: boolean l()>	Permission:android.permission.ACCESS_NETWORK_STATE
<com.wolay.sousien.g: void a(android.content.Context,android.content.Intent,int,com.wolay.sousien.au,int,boolean,boolean)>	Permission:android.permission.VIBRATE
<net.nend.android.x: boolean b(android.content.Context)>	Permission:android.permission.ACCESS_NETWORK_STATE
<com.asiena.xihks.osemwn.ay: java.lang.String n(android.content.Context)>	Permission:android.permission.READ_PHONE_STATE
<com.google.ads.util.AdUtil: java.lang.String d(android.content.Context)>	Permission:android.permission.ACCESS_NETWORK_STATE
<com.wolay.sousien.UaosttActivity: void a()>	Permission:android.permission.WAKE_LOCK
<com.wolay.sousien.ar: java.lang.String c(android.content.Context)>	Permission:android.permission.ACCESS_NETWORK_STATE
<com.asiena.xihks.osemwn.TopaolActivity: boolean a(android.content.Context)>	Permission:android.permission.ACCESS_NETWORK_STATE
<com.wolay.sousien.UaosttActivity: void a(android.content.Context,android.content.Intent)>	Permission:android.permission.WAKE_LOCK
<com.google.ads.x: void c()>	Permission:android.permission.WAKE_LOCK
<com.wolay.sousien.c.e: com.wolay.sousien.c.g k()>	Permission:android.permission.ACCESS_NETWORK_STATE
<jp.co.idac.asadtone.au: void a(android.content.Context,int)>	Permission:android.permission.WAKE_LOCK
<com.asiena.xihks.osemwn.TopaolActivity: void onReceive(android.content.Context,android.content.Intent)>	Permission:android.permission.WAKE_LOCK
<com.dayyren.okbanwty.loraat.ao: protected com.dayyren.okbanwty.loraat.ao(android.content.Context)>	Permission:android.permission.READ_PHONE_STATE
<it.partytrack.sdk.a.f: void a()>	Permission:android.permission.INTERNET
<com.google.android.gcm.GCMBaseIntentService: void onHandleIntent(android.content.Intent)>	Permission:android.permission.WAKE_LOCK
<com.dayyren.okbanwty.loraat.am: java.lang.String c(android.content.Context)>	Permission:android.permission.ACCESS_NETWORK_STATE
<jp.co.idac.asadtone.GCMIntentService: void a(android.content.Intent)>	Permission:android.permission.VIBRATE	Permission:android.permission.WAKE_LOCK
<com.dayyren.okbanwty.loraat.TasektenActivity: void onReceive(android.content.Context,android.content.Intent)>	Permission:android.permission.WAKE_LOCK
<com.wolay.sousien.c.e: boolean l()>	Permission:android.permission.ACCESS_NETWORK_STATE
<com.asiena.xihks.osemwn.aq: void a(android.content.Context,int,java.lang.String,int,int,android.content.Intent,java.lang.String,int)>	Permission:android.permission.VIBRATE
<com.muante.zujly.hullty.ksoaren.d.e: boolean k()>	Permission:android.permission.ACCESS_NETWORK_STATE
<com.dayyren.okbanwty.loraat.TasektenActivity: void a(android.app.Service,int)>	Permission:android.permission.WAKE_LOCK
<android.b.e: void f()>	Permission:android.permission.WAKE_LOCK
