<kxyfyh.yk.f.e: void e()>	Permission:android.permission.WAKE_LOCK
<hll.kxyfyh.b.ch: boolean b()>	Permission:android.permission.WAKE_LOCK
<com.tendcloud.tenddata.u: java.lang.String h()>	Permission:android.permission.ACCESS_WIFI_STATE
<com.tendcloud.tenddata.u: java.lang.String i()>	Permission:android.permission.ACCESS_WIFI_STATE
<com.tendcloud.tenddata.u: java.lang.String o()>	Permission:android.permission.READ_PHONE_STATE
<com.tendcloud.tenddata.u: com.tendcloud.tenddata.v q()>	Permission:android.permission.ACCESS_FINE_LOCATION
<com.tendcloud.tenddata.o: boolean a(java.lang.String,byte[],boolean)>	Permission:android.permission.INTERNET
<kxyfyh.yk.f.e: void b()>	Permission:android.permission.WAKE_LOCK
<kxyfyh.yk.f.e: void a()>	Permission:android.permission.WAKE_LOCK
<com.playphone.psgn.Utils: java.lang.String curl(java.lang.String)>	Permission:android.permission.INTERNET
<com.tendcloud.tenddata.u: java.lang.Long[][] u()>	Permission:android.permission.GET_TASKS
<com.playphone.psgn.Utils: boolean isApplicationSentToBackground(android.content.Context)>	Permission:android.permission.GET_TASKS
<com.tendcloud.tenddata.u: java.lang.String f()>	Permission:android.permission.READ_PHONE_STATE
<com.tendcloud.tenddata.u: java.util.List r()>	Permission:android.permission.ACCESS_FINE_LOCATION
<com.tendcloud.tenddata.u: java.lang.String l()>	Permission:android.permission.READ_PHONE_STATE
<kxyfyh.a.j: void a(android.content.Context)>	Permission:android.permission.READ_PHONE_STATE
<com.tendcloud.tenddata.u: boolean a()>	Permission:android.permission.ACCESS_NETWORK_STATE
<com.tendcloud.tenddata.u: boolean b()>	Permission:android.permission.ACCESS_NETWORK_STATE
<com.playphone.psgn.Utils: boolean isNetworkAvailable(android.content.Context)>	Permission:android.permission.ACCESS_NETWORK_STATE
<hll.kxyfyh.b.ch: public hll.kxyfyh.b.ch()>	Permission:android.permission.WAKE_LOCK
