<android.support.v4.net.ConnectivityManagerCompat$BaseConnectivityManagerCompatImpl: boolean isActiveNetworkMetered(android.net.ConnectivityManager)>	Permission:android.permission.ACCESS_NETWORK_STATE
<com.parse.facebook.Util: java.lang.String openUrl(java.lang.String,java.lang.String,android.os.Bundle)throwsjava.net.MalformedURLException,java.io.IOException>	Permission:android.permission.INTERNET
<com.google.android.gms.maps.model.UrlTileProvider: com.google.android.gms.maps.model.Tile getTile(int,int,int)>	Permission:android.permission.INTERNET
<com.google.ads.internal.AdVideoView: void c()>	Permission:android.permission.WAKE_LOCK
<com.applacarte.util.ALCUtils: boolean isNetworkConnectivityAvailabe(android.content.Context)>	Permission:android.permission.ACCESS_NETWORK_STATE
<com.paypal.android.sdk.c: boolean a()>	Permission:android.permission.ACCESS_NETWORK_STATE
<android.support.v4.net.ConnectivityManagerCompatGingerbread: boolean isActiveNetworkMetered(android.net.ConnectivityManager)>	Permission:android.permission.ACCESS_NETWORK_STATE
<com.parse.signpost.basic.DefaultOAuthProvider: com.parse.signpost.http.HttpRequest createRequest(java.lang.String)throwsjava.net.MalformedURLException,java.io.IOException>	Permission:android.permission.INTERNET
<com.parse.signpost.basic.DefaultOAuthProvider: com.parse.signpost.http.HttpResponse sendRequest(com.parse.signpost.http.HttpRequest)throwsjava.io.IOException>	Permission:android.permission.INTERNET
<com.applacarte.cache.GalleryImageLoader: android.graphics.Bitmap getBitmap(java.lang.String,java.lang.String)>	Permission:android.permission.INTERNET
<com.applacarte.gps.CurrentLocationManager$1: void onLocationChanged(android.location.Location)>	Permission:android.permission.ACCESS_FINE_LOCATION
<com.applacarte.ui.PaymentInstructionActivity: void onCreate(android.os.Bundle)>	Permission:android.permission.INTERNET
<com.applacarte.qrcode.CaptureActivity$1: void onCompletion(android.media.MediaPlayer)>	Permission:android.permission.WAKE_LOCK
<com.google.ads.ae: java.net.HttpURLConnection a(java.net.URL)throwsjava.io.IOException>	Permission:android.permission.INTERNET
<com.google.ads.internal.j: java.net.HttpURLConnection a(java.net.URL)throwsjava.io.IOException>	Permission:android.permission.INTERNET
<com.paypal.android.sdk.payments.z:  com.paypal.android.sdk.payments.z(android.content.Context,boolean)>	Permission:android.permission.INTERNET
<com.parse.ParseCommandCache: public com.parse.ParseCommandCache(android.content.Context)>	Permission:android.permission.ACCESS_NETWORK_STATE
<com.applacarte.qrcode.BeepManager: void playBeepSoundAndVibrate()>	Permission:android.permission.WAKE_LOCK
<com.fasterxml.jackson.databind.ObjectReader: java.io.InputStream _inputStream(java.net.URL)throwsjava.io.IOException>	Permission:android.permission.INTERNET
<com.applacarte.cache.ThemeImageDownloader: void onHandleIntent(android.content.Intent)>	Permission:android.permission.INTERNET
<com.nostra13.universalimageloader.core.download.BaseImageDownloader: java.net.HttpURLConnection createConnection(java.lang.String,java.lang.Object)throwsjava.io.IOException>	Permission:android.permission.INTERNET
<com.google.ads.ae: void run()>	Permission:android.permission.INTERNET
<com.google.android.gms.auth.GoogleAuthUtil: void invalidateToken(android.content.Context,java.lang.String)>	Permission:android.permission.MANAGE_ACCOUNTS
<android.support.v4.net.ConnectivityManagerCompat: android.net.NetworkInfo getNetworkInfoFromBroadcast(android.net.ConnectivityManager,android.content.Intent)>	Permission:android.permission.ACCESS_NETWORK_STATE
<com.google.ads.internal.AdVideoView: void d()>	Permission:android.permission.WAKE_LOCK
<com.applacarte.gps.CurrentLocationManager: void startLocationUpdates()>	Permission:android.permission.ACCESS_FINE_LOCATION
<com.applacarte.util.ALCUtils: boolean wifi(android.content.Context)>	Permission:android.permission.ACCESS_NETWORK_STATE
<com.google.android.apps.analytics.GoogleAnalyticsTracker: boolean dispatch()>	Permission:android.permission.ACCESS_NETWORK_STATE
<com.applacarte.ui.PasscodeActivity$3: void onCompletion(android.media.MediaPlayer)>	Permission:android.permission.WAKE_LOCK
<android.support.v4.net.ConnectivityManagerCompatJellyBean: boolean isActiveNetworkMetered(android.net.ConnectivityManager)>	Permission:android.permission.ACCESS_NETWORK_STATE
<com.applacarte.cache.ImageLoader: java.lang.String getBitmapLoacation(java.lang.String,java.lang.String)>	Permission:android.permission.INTERNET
<com.applacarte.util.ALCUtils: java.lang.String getDeviceID()>	Permission:android.permission.ACCESS_WIFI_STATE	Permission:android.permission.READ_PHONE_STATE
<com.parse.ParseTestUtils: java.net.ServerSocket mockPushServer()>	Permission:android.permission.INTERNET
<com.google.ads.util.AdUtil: java.lang.String i(android.content.Context)>	Permission:android.permission.INTERNET
<com.applacarte.cache.ImageLoader: android.graphics.Bitmap getBitmap(java.lang.String,java.lang.String)>	Permission:android.permission.INTERNET
<io.card.payment.CardIOActivity: void a(android.graphics.Bitmap,io.card.payment.DetectionInfo)>	Permission:android.permission.VIBRATE
<com.google.ads.internal.AdVideoView: void e()>	Permission:android.permission.WAKE_LOCK
<com.google.ads.internal.f$1: java.net.HttpURLConnection a(java.net.URL)throwsjava.io.IOException>	Permission:android.permission.INTERNET
<com.paypal.android.sdk.bj: android.location.Location a(android.location.LocationManager)>	Permission:android.permission.ACCESS_FINE_LOCATION
<com.applacarte.gps.CurrentLocationManager: void checkIsLocationProviderEnabled()>	Permission:android.permission.ACCESS_FINE_LOCATION
<com.parse.ParseCommandCache$1: void onReceive(android.content.Context,android.content.Intent)>	Permission:android.permission.ACCESS_NETWORK_STATE
<com.applacarte.util.ALCUtils: boolean checkConnection(android.content.Context)>	Permission:android.permission.ACCESS_NETWORK_STATE
<com.applacarte.util.ALCUtils: java.io.InputStream downloadUrl(java.lang.String)throwsjava.io.IOException>	Permission:android.permission.INTERNET
<com.applacarte.facebook.Util: java.lang.String openUrl(java.lang.String,java.lang.String,android.os.Bundle)throwsjava.net.MalformedURLException,java.io.IOException>	Permission:android.permission.INTERNET
<com.google.ads.util.AdUtil: java.lang.String d(android.content.Context)>	Permission:android.permission.ACCESS_NETWORK_STATE
<com.parse.StandardPushCallback: void run()>	Permission:android.permission.VIBRATE
<com.google.ads.internal.AdWebView: public com.google.ads.internal.AdWebView(com.google.ads.n,com.google.ads.AdSize)>	Permission:android.permission.INTERNET
<com.applacarte.qrcode.CameraManager: void openDriver(android.view.SurfaceHolder)throwsjava.io.IOException>	Permission:android.permission.CAMERA
<com.applacarte.util.ALCUtils: boolean cellular(android.content.Context)>	Permission:android.permission.ACCESS_NETWORK_STATE
<com.fasterxml.jackson.core.JsonFactory: java.io.InputStream _optimizedStreamFromURL(java.net.URL)throwsjava.io.IOException>	Permission:android.permission.INTERNET
<com.judopay.android.api.action.BaseAction: java.net.HttpURLConnection openConnection(java.lang.CharSequence,java.util.List<com.judopay.android.api.action.NameValue>,java.lang.String,int)throwscom.judopay.android.api.exception.NetworkException,java.io.IOException>	Permission:android.permission.INTERNET
<com.google.ads.internal.AdVideoView: void b()>	Permission:android.permission.WAKE_LOCK
<android.support.v4.net.ConnectivityManagerCompatHoneycombMR2: boolean isActiveNetworkMetered(android.net.ConnectivityManager)>	Permission:android.permission.ACCESS_NETWORK_STATE
