<org.apache.cordova.FileTransfer$4: void run()>	Permission:android.permission.INTERNET
<org.apache.cordova.CordovaWebView: public org.apache.cordova.CordovaWebView(android.content.Context,android.util.AttributeSet)>	Permission:android.permission.INTERNET
<org.apache.cordova.Notification: void vibrate(long)>	Permission:android.permission.WAKE_LOCK
<org.apache.cordova.CordovaWebView: public org.apache.cordova.CordovaWebView(android.content.Context,android.util.AttributeSet,int)>	Permission:android.permission.INTERNET
<org.apache.cordova.AudioPlayer: boolean onError(android.media.MediaPlayer,int,int)>	Permission:android.permission.WAKE_LOCK
<org.apache.cordova.NetworkManager: boolean execute(java.lang.String,org.json.JSONArray,org.apache.cordova.api.CallbackContext)>	Permission:android.permission.ACCESS_NETWORK_STATE
<org.apache.cordova.NetworkManager$1: void onReceive(android.content.Context,android.content.Intent)>	Permission:android.permission.ACCESS_NETWORK_STATE
<org.apache.cordova.Notification: void beep(long)>	Permission:android.permission.WAKE_LOCK
<org.apache.cordova.AudioPlayer: void startPlaying(java.lang.String)>	Permission:android.permission.WAKE_LOCK
<org.apache.cordova.ContactAccessorSdk5: java.lang.String save(org.json.JSONObject)>	Permission:android.permission.GET_ACCOUNTS
<org.apache.cordova.GeoBroker: boolean execute(java.lang.String,org.json.JSONArray,org.apache.cordova.api.CallbackContext)throwsorg.json.JSONException>	Permission:android.permission.ACCESS_FINE_LOCATION
<org.apache.cordova.AudioPlayer: void stopPlaying()>	Permission:android.permission.WAKE_LOCK
<org.apache.cordova.GPSListener: void start()>	Permission:android.permission.ACCESS_FINE_LOCATION
<org.apache.cordova.CordovaWebView: public org.apache.cordova.CordovaWebView(android.content.Context,android.util.AttributeSet,int,boolean)>	Permission:android.permission.INTERNET
<org.apache.cordova.AudioPlayer: void pausePlaying()>	Permission:android.permission.WAKE_LOCK
<org.apache.cordova.AudioPlayer: void startRecording(java.lang.String)>	Permission:android.permission.RECORD_AUDIO
<org.apache.cordova.CordovaLocationListener: void start()>	Permission:android.permission.ACCESS_FINE_LOCATION
<org.apache.cordova.FileTransfer$1: void run()>	Permission:android.permission.INTERNET
<org.apache.cordova.InAppBrowser$1: void run()>	Permission:android.permission.INTERNET
<org.apache.cordova.AudioPlayer: void destroy()>	Permission:android.permission.WAKE_LOCK
<org.apache.cordova.CordovaWebView: public org.apache.cordova.CordovaWebView(android.content.Context)>	Permission:android.permission.INTERNET
<org.apache.cordova.AudioPlayer: void onPrepared(android.media.MediaPlayer)>	Permission:android.permission.WAKE_LOCK
