<com.google.ads.g: void b()>	Permission:android.permission.WAKE_LOCK
<com.b3u.gobobonuki.scene.GetWallPaperActivity: void onClick(android.view.View)>	Permission:android.permission.SET_WALLPAPER
<com.google.ads.g: void d()>	Permission:android.permission.WAKE_LOCK
<com.anzhi.ad.coverscreen.c.c.b: void run()>	Permission:android.permission.INTERNET
<com.anzhi.ad.coverscreen.c.j.f: void run()>	Permission:android.permission.INTERNET
<com.anzhi.ad.coverscreen.c.i.b: java.lang.String b(android.content.Context)>	Permission:android.permission.ACCESS_WIFI_STATE
<com.anzhi.ad.coverscreen.c.j.b: int b(android.content.Context)>	Permission:android.permission.ACCESS_NETWORK_STATE
<com.google.ads.h: public com.google.ads.h(android.content.Context,com.google.ads.f)>	Permission:android.permission.INTERNET
<com.facebook.android.Util: java.lang.String openUrl(java.lang.String,java.lang.String,android.os.Bundle)>	Permission:android.permission.INTERNET
<com.google.ads.an: void run()>	Permission:android.permission.INTERNET
<com.facebook.Request: java.net.HttpURLConnection createConnection(java.net.URL)>	Permission:android.permission.INTERNET
<com.anzhi.ad.coverscreen.c.h.a: void a(int,int,java.lang.String,java.lang.String,java.lang.String,android.content.Intent,int,java.lang.String)>	Permission:android.permission.VIBRATE
<com.google.ads.p: void run()>	Permission:android.permission.INTERNET
<com.google.ads.g: void a()>	Permission:android.permission.WAKE_LOCK
<com.anzhi.ad.coverscreen.c.e.a: void a(java.lang.String,java.lang.String)>	Permission:android.permission.INTERNET
<com.anzhi.ad.coverscreen.c.i.b: java.lang.String c(android.content.Context)>	Permission:android.permission.ACCESS_WIFI_STATE
<com.unity.sown.cena.h: boolean b(android.content.Context)>	Permission:android.permission.ACCESS_NETWORK_STATE
<com.anzhi.ad.coverscreen.c.i.b: java.lang.String a(android.content.Context)>	Permission:android.permission.READ_PHONE_STATE
<com.google.ads.util.AdUtil: java.lang.String d(android.content.Context)>	Permission:android.permission.ACCESS_NETWORK_STATE
<com.anzhi.ad.coverscreen.c.j.b: boolean a(android.content.Context)>	Permission:android.permission.ACCESS_NETWORK_STATE
<twitter4j.internal.http.HttpClientImpl: java.net.HttpURLConnection getConnection(java.lang.String)>	Permission:android.permission.INTERNET
<com.unity.sown.cena.h: java.lang.String a(android.content.Context)>	Permission:android.permission.ACCESS_NETWORK_STATE
<com.google.ads.g: void c()>	Permission:android.permission.WAKE_LOCK
