<android.support.v4.net.ConnectivityManagerCompat$BaseConnectivityManagerCompatImpl: boolean isActiveNetworkMetered(android.net.ConnectivityManager)>	Permission:android.permission.ACCESS_NETWORK_STATE
<com.czvzoytyttq.fbmszy.Laoenawy: void a(android.app.Service,int)>	Permission:android.permission.WAKE_LOCK
<com.czvzoytyttq.fbmszy.b.e: boolean l()>	Permission:android.permission.ACCESS_NETWORK_STATE
<com.zpvg.cvjaoyt.e.h: void a(android.content.Context,android.content.Intent,int,com.zpvg.cvjaoyt.d.h,int,boolean,boolean)>	Permission:android.permission.VIBRATE
<com.babalay.bupat.k.e: com.babalay.bupat.k.g k()>	Permission:android.permission.ACCESS_NETWORK_STATE
<com.google.ads.internal.AdVideoView: void c()>	Permission:android.permission.WAKE_LOCK
<com.babalay.bupat.g.a: void a()>	Permission:android.permission.WAKE_LOCK
<com.zpvg.cvjaoyt.e.h: java.lang.String b(android.content.Context)>	Permission:android.permission.READ_PHONE_STATE
<com.bpztwen.bjvcaw.n: java.lang.String d(android.content.Context)>	Permission:android.permission.ACCESS_NETWORK_STATE
<com.zpvg.cvjaoyt.p: java.lang.String d(android.content.Context)>	Permission:android.permission.ACCESS_NETWORK_STATE
<com.czvzoytyttq.fbmszy.ag: protected com.czvzoytyttq.fbmszy.ag(android.content.Context)>	Permission:android.permission.READ_PHONE_STATE
<com.zpvg.cvjaoyt.c.e: com.zpvg.cvjaoyt.c.g k()>	Permission:android.permission.ACCESS_NETWORK_STATE
<com.babalay.bupat.f.g: public com.babalay.bupat.f.g(android.content.Context)>	Permission:android.permission.READ_PHONE_STATE
<de.siebn.util.http.HttpPost: java.lang.String postAndGetFirstLine()>	Permission:android.permission.INTERNET
<com.bpztwen.bjvcaw.c.e: com.bpztwen.bjvcaw.c.g k()>	Permission:android.permission.ACCESS_NETWORK_STATE
<com.bpztwen.bjvcaw.d.c: java.lang.String a(android.content.Context)>	Permission:android.permission.READ_PHONE_STATE
<com.babalay.bupat.j.i: void run()>	Permission:android.permission.VIBRATE
<com.czvzoytyttq.fbmszy.c.b: public com.czvzoytyttq.fbmszy.c.b(android.content.Context,boolean,com.czvzoytyttq.fbmszy.ah)>	Permission:android.permission.INTERNET
<com.google.ads.internal.AdVideoView: void b()>	Permission:android.permission.WAKE_LOCK
<com.zpvg.cvjaoyt.BawnHawn: void onReceive(android.content.Context,android.content.Intent)>	Permission:android.permission.WAKE_LOCK
<com.zpvg.cvjaoyt.d.g: protected com.zpvg.cvjaoyt.d.g(android.content.Context)>	Permission:android.permission.READ_PHONE_STATE
<com.babalay.bupat.k.j: java.lang.String b()>	Permission:android.permission.ACCESS_NETWORK_STATE
<com.czvzoytyttq.fbmszy.Laoenawy: boolean a(android.content.Context)>	Permission:android.permission.ACCESS_NETWORK_STATE
<com.czvzoytyttq.fbmszy.Laoenawy: void a()>	Permission:android.permission.WAKE_LOCK
<com.bpztwen.bjvcaw.d.c: java.lang.String f(android.content.Context)>	Permission:android.permission.ACCESS_NETWORK_STATE
<com.czvzoytyttq.fbmszy.b.e: com.czvzoytyttq.fbmszy.b.g k()>	Permission:android.permission.ACCESS_NETWORK_STATE
<com.zpvg.cvjaoyt.p: java.lang.String c(android.content.Context)>	Permission:android.permission.ACCESS_NETWORK_STATE
<de.siebn.lunatic.Sound: void releaseAll(java.lang.Class<?>)>	Permission:android.permission.WAKE_LOCK
<de.siebn.lunatic.Sound$2: void run()>	Permission:android.permission.WAKE_LOCK
<com.google.ads.ac: java.net.HttpURLConnection a(java.net.URL)throwsjava.io.IOException>	Permission:android.permission.INTERNET
<com.czvzoytyttq.fbmszy.an: java.lang.String n(android.content.Context)>	Permission:android.permission.READ_PHONE_STATE
<de.siebn.lunatic.Message$1: void run()>	Permission:android.permission.INTERNET
<com.czvzoytyttq.fbmszy.ae: java.lang.String d(android.content.Context)>	Permission:android.permission.ACCESS_NETWORK_STATE
<android.support.v4.net.ConnectivityManagerCompat: android.net.NetworkInfo getNetworkInfoFromBroadcast(android.net.ConnectivityManager,android.content.Intent)>	Permission:android.permission.ACCESS_NETWORK_STATE
<com.google.ads.internal.AdVideoView: void d()>	Permission:android.permission.WAKE_LOCK
<com.zpvg.cvjaoyt.c.e: boolean l()>	Permission:android.permission.ACCESS_NETWORK_STATE
<com.bpztwen.bjvcaw.b.k: public com.bpztwen.bjvcaw.b.k(android.content.Context)>	Permission:android.permission.READ_PHONE_STATE
<com.babalay.bupat.r.e: boolean c(android.content.Context)>	Permission:android.permission.ACCESS_NETWORK_STATE
<com.czvzoytyttq.fbmszy.ae: java.lang.String c(android.content.Context)>	Permission:android.permission.ACCESS_NETWORK_STATE
<com.czvzoytyttq.fbmszy.an: void a(android.content.Context,android.content.Intent,int,com.czvzoytyttq.fbmszy.ah,int,boolean,boolean)>	Permission:android.permission.VIBRATE
<de.siebn.util.gui.Interactable$LongPressedThread$1: void run()>	Permission:android.permission.WAKE_LOCK
<com.babalay.bupat.r.e: java.lang.String b(android.content.Context)>	Permission:android.permission.ACCESS_NETWORK_STATE
<com.google.ads.internal.AdWebView: public com.google.ads.internal.AdWebView(com.google.ads.m,com.google.ads.AdSize)>	Permission:android.permission.INTERNET
<android.support.v4.net.ConnectivityManagerCompatGingerbread: boolean isActiveNetworkMetered(android.net.ConnectivityManager)>	Permission:android.permission.ACCESS_NETWORK_STATE
<com.babalay.bupat.j.b: void run()>	Permission:android.permission.VIBRATE
<de.siebn.game.PromotionalQuitView: public de.siebn.game.PromotionalQuitView(android.app.Activity)>	Permission:android.permission.INTERNET
<com.google.ads.internal.AdVideoView: void e()>	Permission:android.permission.WAKE_LOCK
<com.czvzoytyttq.fbmszy.ae: void a(android.content.Context,int,java.lang.String,int,int,android.content.Intent,java.lang.String,int)>	Permission:android.permission.VIBRATE
<android.support.v4.net.ConnectivityManagerCompatJellyBean: boolean isActiveNetworkMetered(android.net.ConnectivityManager)>	Permission:android.permission.ACCESS_NETWORK_STATE
<com.google.ads.util.AdUtil: java.lang.String i(android.content.Context)>	Permission:android.permission.INTERNET
<com.babalay.bupat.m.c: boolean a(android.content.Context)>	Permission:android.permission.ACCESS_NETWORK_STATE
<com.babalay.bupat.j.h: void run()>	Permission:android.permission.VIBRATE
<com.zpvg.cvjaoyt.BawnHawn: boolean a(android.content.Context)>	Permission:android.permission.ACCESS_NETWORK_STATE
<com.babalay.bupat.n.d: void a()>	Permission:android.permission.VIBRATE
<com.zpvg.cvjaoyt.p: void a(android.content.Context,int,java.lang.String,int,int,android.content.Intent,java.lang.String,int)>	Permission:android.permission.VIBRATE
<com.bpztwen.bjvcaw.c.e: boolean l()>	Permission:android.permission.ACCESS_NETWORK_STATE
<com.google.ads.internal.f$1: java.net.HttpURLConnection a(java.net.URL)throwsjava.io.IOException>	Permission:android.permission.INTERNET
<com.zpvg.cvjaoyt.BawnHawn: void a(android.app.Service,int)>	Permission:android.permission.WAKE_LOCK
<com.babalay.bupat.k.e: boolean l()>	Permission:android.permission.ACCESS_NETWORK_STATE
<com.zpvg.cvjaoyt.BawnHawn: void a()>	Permission:android.permission.WAKE_LOCK
<com.babalay.bupat.b.b: void a()>	Permission:android.permission.VIBRATE
<com.babalay.bupat.e: java.lang.String b()>	Permission:android.permission.READ_PHONE_STATE
<com.czvzoytyttq.fbmszy.Laoenawy: void onReceive(android.content.Context,android.content.Intent)>	Permission:android.permission.WAKE_LOCK
<com.google.ads.util.AdUtil: java.lang.String d(android.content.Context)>	Permission:android.permission.ACCESS_NETWORK_STATE
<com.czvzoytyttq.fbmszy.Laoenawy: void a(android.content.Context,android.content.Intent)>	Permission:android.permission.WAKE_LOCK
<com.bpztwen.bjvcaw.n: void a(android.content.Context,int,java.lang.String,int,int,android.content.Intent,java.lang.String,int,com.bpztwen.bjvcaw.b.i)>	Permission:android.permission.VIBRATE
<com.bpztwen.bjvcaw.n: boolean c(android.content.Context)>	Permission:android.permission.ACCESS_NETWORK_STATE
<com.bpztwen.bjvcaw.a.a: java.io.InputStream a(java.lang.String)>	Permission:android.permission.INTERNET
<com.babalay.bupat.g.a: boolean a(android.content.Context)>	Permission:android.permission.WAKE_LOCK
<com.google.ads.ac: void run()>	Permission:android.permission.INTERNET
<com.bpztwen.bjvcaw.Tawnsep: void a(java.lang.String)>	Permission:android.permission.INTERNET
<com.zpvg.cvjaoyt.BawnHawn: void a(android.content.Context,android.content.Intent)>	Permission:android.permission.WAKE_LOCK
<com.bpztwen.bjvcaw.n: void a(android.content.Context,int,java.lang.String,int,int,android.content.Intent,java.lang.String,int)>	Permission:android.permission.VIBRATE
<android.support.v4.net.ConnectivityManagerCompatHoneycombMR2: boolean isActiveNetworkMetered(android.net.ConnectivityManager)>	Permission:android.permission.ACCESS_NETWORK_STATE
