<net.youmi.android.u: java.lang.String a(android.content.Context)>	Permission:android.permission.ACCESS_NETWORK_STATE
<net.youmi.android.az: public net.youmi.android.az(android.app.Activity,net.youmi.android.r)>	Permission:android.permission.INTERNET
<net.youmi.android.bx: java.io.File a(java.lang.String...)>	Permission:android.permission.INTERNET
<net.youmi.android.br: int b()>	Permission:android.permission.INTERNET
<net.youmi.android.v: void b(android.content.Context)>	Permission:android.permission.VIBRATE
<net.youmi.android.dx: java.lang.String a(java.lang.String,java.lang.String)>	Permission:android.permission.INTERNET
<com.android.remotecontrolppt.fastcontrolActivity: void onResume()>	Permission:android.permission.INTERNET
<net.youmi.android.az: public net.youmi.android.az(android.app.Activity,net.youmi.android.cv,net.youmi.android.r)>	Permission:android.permission.INTERNET
<net.youmi.android.bi:  net.youmi.android.bi(android.content.Context)>	Permission:android.permission.READ_PHONE_STATE
<com.android.remotecontrolppt.RemoteControlPPTActivity: void onResume()>	Permission:android.permission.INTERNET
<net.youmi.android.eh: java.lang.String g(android.content.Context)>	Permission:android.permission.READ_PHONE_STATE	Permission:android.permission.ACCESS_FINE_LOCATION
<net.youmi.android.et: int a(android.content.Context,java.lang.String)>	Permission:android.permission.INTERNET
<net.youmi.android.u: boolean b(android.content.Context)>	Permission:android.permission.ACCESS_NETWORK_STATE
<net.youmi.android.dj: int b()>	Permission:android.permission.INTERNET
<net.youmi.android.by: java.lang.String a(java.lang.String,java.util.List)>	Permission:android.permission.INTERNET
<net.youmi.android.eo: void run()>	Permission:android.permission.ACCESS_FINE_LOCATION
<net.youmi.android.dx: java.lang.String[] a(java.lang.String[])>	Permission:android.permission.INTERNET
<net.youmi.android.fa: java.lang.Integer a(java.lang.String...)>	Permission:android.permission.INTERNET
<net.youmi.android.ei: void a(android.content.Context,android.os.Handler)>	Permission:android.permission.ACCESS_FINE_LOCATION
<net.youmi.android.dy: void i()>	Permission:android.permission.INTERNET
<net.youmi.android.eh: void c(android.content.Context)>	Permission:android.permission.READ_PHONE_STATE
