<com.zestadz.android.ZestADZAdView: java.lang.Object fetch(java.lang.String)throwsjava.net.MalformedURLException,java.io.IOException>	Permission:android.permission.INTERNET
<com.mobclix.android.sdk.MobclixCreative$MobclixWebView: public com.mobclix.android.sdk.MobclixCreative$MobclixWebView(com.mobclix.android.sdk.MobclixCreative)>	Permission:android.permission.INTERNET
<c:  c(d)>	Permission:android.permission.INTERNET
<com.mobclix.android.sdk.MobclixBrowserActivity$MobclixVideoView: void loadVideoAd()>	Permission:android.permission.WAKE_LOCK
<com.google.ads.AdActivity: void onDestroy()>	Permission:android.permission.WAKE_LOCK
<com.mobclix.android.sdk.MobclixJavascriptInterface: void resumeListeners()>	Permission:android.permission.ACCESS_FINE_LOCATION
<com.adwhirl.AdWhirlManager: android.location.Location getLocation()>	Permission:android.permission.ACCESS_FINE_LOCATION
<com.mobclix.android.sdk.MobclixCreative$MobclixWebView$1: boolean onError(android.media.MediaPlayer,int,int)>	Permission:android.permission.WAKE_LOCK
<com.mobclix.android.sdk.MobclixBrowserActivity: void onStop()>	Permission:android.permission.WAKE_LOCK
<g: public g(android.content.Context,com.google.ads.AdSize)>	Permission:android.permission.INTERNET
<u: java.lang.String c(android.content.Context)>	Permission:android.permission.ACCESS_NETWORK_STATE
<com.mobclix.android.sdk.MobclixContactsSdk5: void addContact(org.json.JSONObject,android.app.Activity)throwsjava.lang.Exception>	Permission:android.permission.GET_ACCOUNTS
<com.google.ads.GoogleAdView: public com.google.ads.GoogleAdView(android.content.Context)>	Permission:android.permission.INTERNET
<com.mobclix.android.sdk.MobclixBrowserActivity: void runNextAsyncRequest()>	Permission:android.permission.WAKE_LOCK
<com.mobclix.android.sdk.MobclixContactsSdk5: org.json.JSONObject loadContact(android.content.ContentResolver,android.net.Uri)>	Permission:android.permission.READ_SOCIAL_STREAM
<com.mobclix.android.sdk.MobclixLocation$GetLastLocation: void run()>	Permission:android.permission.ACCESS_FINE_LOCATION
<com.androgames.BubbleBurst.BubbleBurst: void onCompletion(android.media.MediaPlayer)>	Permission:android.permission.WAKE_LOCK
<com.millennialmedia.android.MMAdViewWebOverlay$OverlayJSInterface: void shouldVibrate(long)>	Permission:android.permission.WAKE_LOCK
<com.mobclix.android.sdk.MobclixBrowserActivity$MobclixVideoView$1: void onClick(android.view.View)>	Permission:android.permission.WAKE_LOCK
<com.mobclix.android.sdk.MobclixCreative$MobclixWebView: void killCustomViewVideo(android.view.View,java.lang.Object)>	Permission:android.permission.WAKE_LOCK
<com.mobclix.android.sdk.MobclixBrowserActivity$MobclixBrowser:  com.mobclix.android.sdk.MobclixBrowserActivity$MobclixBrowser(com.mobclix.android.sdk.MobclixBrowserActivity,android.app.Activity,java.lang.String)>	Permission:android.permission.INTERNET
<com.zestadz.android.ZestadzAd$1$1: void run()>	Permission:android.permission.INTERNET
<com.mobclix.android.sdk.Mobclix$SessionPolling: boolean isTopTask()>	Permission:android.permission.GET_TASKS
<com.mobclix.android.sdk.MobclixJavascriptInterface: void deviceFlashlightResume()throwsjava.lang.Exception>	Permission:android.permission.CAMERA
<s: void a(d,java.util.HashMap<java.lang.String,java.lang.String>,android.webkit.WebView)>	Permission:android.permission.WAKE_LOCK
<com.zestadz.android.AdManager: java.lang.String getUserAgent(android.content.Context)>	Permission:android.permission.INTERNET
<com.mobclix.android.sdk.MobclixCreative$CustomAdThread: void run()>	Permission:android.permission.INTERNET
<com.androgames.BubbleBurst.Help: void onCreate(android.os.Bundle)>	Permission:android.permission.INTERNET
<com.mobclix.android.sdk.MobclixAnalytics$Sync: void run()>	Permission:android.permission.INTERNET
<com.mobclix.android.sdk.MobclixCreative$MobclixWebView: public com.mobclix.android.sdk.MobclixCreative$MobclixWebView(com.mobclix.android.sdk.MobclixFullScreenAdView)>	Permission:android.permission.INTERNET
<com.scoreloop.client.android.core.spi.AuthRequest: void a(org.apache.http.client.methods.HttpUriRequest)>	Permission:android.permission.INTERNET
<com.millennialmedia.android.MMAdView: java.lang.String getAuid(android.app.Activity)>	Permission:android.permission.READ_PHONE_STATE
<com.millennialmedia.android.MillennialMediaView: void pause()>	Permission:android.permission.WAKE_LOCK
<com.mobclix.android.sdk.MobclixFullScreenAdView: boolean displayRequestedAd()>	Permission:android.permission.GET_TASKS
<com.millennialmedia.android.MMAdViewWebOverlay:  com.millennialmedia.android.MMAdViewWebOverlay(android.app.Activity,int,long,java.lang.String,boolean,java.lang.String,boolean,boolean,boolean)>	Permission:android.permission.INTERNET
<com.millennialmedia.android.MillennialMediaView: void stopPlayback()>	Permission:android.permission.WAKE_LOCK
<com.millennialmedia.android.HttpHeadRequest: java.lang.String sendRequest(java.lang.String)>	Permission:android.permission.INTERNET
<com.millennialmedia.android.MMAdView: void startConversionTrackerWithGoalId(android.content.Context,java.lang.String)>	Permission:android.permission.ACCESS_NETWORK_STATE
<com.androgames.BubbleBurst.ScoreBoard$2: void run()>	Permission:android.permission.WAKE_LOCK
<com.androgames.BubbleBurst.BoardSurfaceView$6: void run()>	Permission:android.permission.WAKE_LOCK
<com.millennialmedia.android.MMAdViewController$MMJSInterface: void vibrate(int)>	Permission:android.permission.WAKE_LOCK
<com.millennialmedia.android.MMAdViewController$1: void run()>	Permission:android.permission.ACCESS_NETWORK_STATE
<com.millennialmedia.android.MMAdViewController$4: void run()>	Permission:android.permission.INTERNET
<com.millennialmedia.android.VideoPlayer$VideoServer: public com.millennialmedia.android.VideoPlayer$VideoServer(com.millennialmedia.android.VideoPlayer,java.lang.String,boolean)>	Permission:android.permission.INTERNET
<com.androgames.BubbleBurst.ScoreBoard: void onCompletion(android.media.MediaPlayer)>	Permission:android.permission.WAKE_LOCK
<com.google.ads.GoogleAdView: public com.google.ads.GoogleAdView(android.content.Context,android.util.AttributeSet)>	Permission:android.permission.INTERNET
<com.mdotm.android.ads.MdotMManager: java.lang.String getDeviceId(android.content.Context)throwsjava.security.NoSuchAlgorithmException>	Permission:android.permission.READ_PHONE_STATE
<com.giffads.android.sdk.v3.Util: boolean isNetworkAvailable(android.content.Context)>	Permission:android.permission.ACCESS_NETWORK_STATE
<com.millennialmedia.android.MMAdViewWebOverlay: void loadWebContent(java.lang.String)>	Permission:android.permission.ACCESS_NETWORK_STATE
<com.zestadz.android.ZestadzAd: java.lang.Object fetch(java.lang.String)throwsjava.net.MalformedURLException,java.io.IOException>	Permission:android.permission.INTERNET
<com.mobclix.android.sdk.MobclixJavascriptInterface: boolean gpsStart(float,java.lang.String,java.lang.String,java.lang.String)>	Permission:android.permission.ACCESS_FINE_LOCATION
<com.mdotm.android.ads.MdotmLandingPage: void onCreate(android.os.Bundle)>	Permission:android.permission.INTERNET
<com.mobclix.android.sdk.MobclixUtility$POSTThread: void run()>	Permission:android.permission.INTERNET
<com.mobclix.android.sdk.MobclixContactsSdk3_4: void addContact(org.json.JSONObject,android.app.Activity)throwsjava.lang.Exception>	Permission:android.permission.READ_SOCIAL_STREAM
<com.mobclix.android.sdk.MobclixLocation: boolean getLocation(android.content.Context,com.mobclix.android.sdk.MobclixLocation$LocationResult)>	Permission:android.permission.ACCESS_FINE_LOCATION
<com.mobclix.android.sdk.MobclixAdView$FetchAdResponseThread: void run()>	Permission:android.permission.GET_TASKS
<com.mobclix.android.sdk.MobclixBrowserActivity$MobclixHTML5Video:  com.mobclix.android.sdk.MobclixBrowserActivity$MobclixHTML5Video(com.mobclix.android.sdk.MobclixBrowserActivity,android.app.Activity)>	Permission:android.permission.WAKE_LOCK
<com.google.ads.InstallReceiver: void onReceive(android.content.Context,android.content.Intent)>	Permission:android.permission.INTERNET
<com.millennialmedia.android.MMAdViewWebOverlay$OverlayWebViewClient: boolean shouldOverrideUrlLoading(android.webkit.WebView,java.lang.String)>	Permission:android.permission.INTERNET
<com.millennialmedia.android.MillennialMediaView: void start()>	Permission:android.permission.WAKE_LOCK
<com.mobclix.android.sdk.MobclixJavascriptInterface:  com.mobclix.android.sdk.MobclixJavascriptInterface(com.mobclix.android.sdk.MobclixCreative$MobclixWebView,boolean)>	Permission:android.permission.ACCESS_FINE_LOCATION
<com.millennialmedia.android.MMAdView: void startConversionTrackerWithGoalId(java.lang.String)>	Permission:android.permission.ACCESS_NETWORK_STATE
<com.mobclix.android.sdk.MobclixJavascriptInterface: void deviceVibrate(java.lang.String,java.lang.String)>	Permission:android.permission.WAKE_LOCK
<com.mobclix.android.sdk.MobclixBrowserActivity: void onStart()>	Permission:android.permission.WAKE_LOCK
<com.scoreloop.client.android.core.spi.myspace.b: void onStart()>	Permission:android.permission.INTERNET
<com.mobclix.android.sdk.Mobclix$MobclixHttpClient: org.apache.http.HttpResponse execute()throwsorg.apache.http.client.ClientProtocolException,java.io.IOException>	Permission:android.permission.INTERNET
<com.mobclix.android.sdk.MobclixJavascriptInterface$SendImageToServerThread: void run()>	Permission:android.permission.INTERNET
<com.millennialmedia.android.HandShake: java.lang.String getAuid(android.content.Context)>	Permission:android.permission.READ_PHONE_STATE
<com.mobclix.android.sdk.MobclixJavascriptInterface: void onLocationChanged(android.location.Location)>	Permission:android.permission.ACCESS_FINE_LOCATION
