<com.cwillay.niwin.at: java.lang.String n(android.content.Context)>	Permission:android.permission.READ_PHONE_STATE
<com.cwillay.e.h: void a(android.content.Context,android.content.Intent,int,com.cwillay.d.h,int,boolean,boolean)>	Permission:android.permission.VIBRATE
<com.playphone.psgn.Utils: boolean isNetworkAvailable(android.content.Context)>	Permission:android.permission.ACCESS_NETWORK_STATE
<com.tendcloud.tenddata.u: java.lang.String i()>	Permission:android.permission.ACCESS_WIFI_STATE
<com.cwillay.coarn.NatuIwin: void a(android.content.Context,android.content.Intent)>	Permission:android.permission.WAKE_LOCK
<com.cwillay.c.e: boolean l()>	Permission:android.permission.ACCESS_NETWORK_STATE
<com.cwillay.coarn.e.g: void a(android.content.Context,int,java.lang.String,int,int,android.content.Intent,java.lang.String,int)>	Permission:android.permission.VIBRATE
<com.cwillay.niwin.al: java.lang.String c(android.content.Context)>	Permission:android.permission.ACCESS_NETWORK_STATE
<com.cwillay.tusrck.r: java.lang.String d(android.content.Context)>	Permission:android.permission.ACCESS_NETWORK_STATE
<kxyfyh.yk.f.e: void a()>	Permission:android.permission.WAKE_LOCK
<com.cwillay.niwin.b.e: boolean l()>	Permission:android.permission.ACCESS_NETWORK_STATE
<com.playphone.psgn.Utils: java.lang.String curl(java.lang.String)>	Permission:android.permission.INTERNET
<com.cwillay.niwin.RTawsnActivity: void onReceive(android.content.Context,android.content.Intent)>	Permission:android.permission.WAKE_LOCK
<com.cwillay.coarn.f.a: void a(android.content.Context,android.content.Intent,int,com.cwillay.coarn.e.j,int,boolean,boolean)>	Permission:android.permission.VIBRATE
<com.tendcloud.tenddata.u: java.lang.String f()>	Permission:android.permission.READ_PHONE_STATE
<com.cwillay.FwaunActivity: void a(android.content.Context,android.content.Intent)>	Permission:android.permission.WAKE_LOCK
<kxyfyh.yk.f.e: void e()>	Permission:android.permission.WAKE_LOCK
<com.cwillay.FwaunActivity: void onReceive(android.content.Context,android.content.Intent)>	Permission:android.permission.WAKE_LOCK
<com.cwillay.p: java.lang.String c(android.content.Context)>	Permission:android.permission.ACCESS_NETWORK_STATE
<com.cwillay.FwaunActivity: void a()>	Permission:android.permission.WAKE_LOCK
<com.cwillay.tusrck.r: boolean c(android.content.Context)>	Permission:android.permission.ACCESS_NETWORK_STATE
<com.cwillay.niwin.RTawsnActivity: boolean a(android.content.Context)>	Permission:android.permission.ACCESS_NETWORK_STATE
<com.cwillay.tusrck.b.k: public com.cwillay.tusrck.b.k(android.content.Context)>	Permission:android.permission.READ_PHONE_STATE
<com.cwillay.p: java.lang.String d(android.content.Context)>	Permission:android.permission.ACCESS_NETWORK_STATE
<com.cwillay.p: void a(android.content.Context,int,java.lang.String,int,int,android.content.Intent,java.lang.String,int)>	Permission:android.permission.VIBRATE
<com.cwillay.tusrck.r: void a(android.content.Context,int,java.lang.String,int,int,android.content.Intent,java.lang.String,int)>	Permission:android.permission.VIBRATE
<com.cwillay.coarn.NatuIwin: void onReceive(android.content.Context,android.content.Intent)>	Permission:android.permission.WAKE_LOCK
<com.tendcloud.tenddata.u: com.tendcloud.tenddata.v q()>	Permission:android.permission.ACCESS_FINE_LOCATION
<com.playphone.psgn.Utils: boolean isApplicationSentToBackground(android.content.Context)>	Permission:android.permission.GET_TASKS
<com.cwillay.tusrck.d.c: java.lang.String a(android.content.Context)>	Permission:android.permission.READ_PHONE_STATE
<com.tendcloud.tenddata.u: java.util.List r()>	Permission:android.permission.ACCESS_FINE_LOCATION
<com.cwillay.niwin.al: java.lang.String d(android.content.Context)>	Permission:android.permission.ACCESS_NETWORK_STATE
<com.tendcloud.tenddata.u: boolean a()>	Permission:android.permission.ACCESS_NETWORK_STATE
<com.cwillay.d.g: protected com.cwillay.d.g(android.content.Context)>	Permission:android.permission.READ_PHONE_STATE
<com.cwillay.e.h: java.lang.String b(android.content.Context)>	Permission:android.permission.READ_PHONE_STATE
<com.cwillay.niwin.RTawsnActivity: void a(android.content.Context,android.content.Intent)>	Permission:android.permission.WAKE_LOCK
<com.cwillay.niwin.b.e: com.cwillay.niwin.b.g k()>	Permission:android.permission.ACCESS_NETWORK_STATE
<com.cwillay.coarn.e.g: java.lang.String c(android.content.Context)>	Permission:android.permission.ACCESS_NETWORK_STATE
<com.cwillay.c.e: com.cwillay.c.g k()>	Permission:android.permission.ACCESS_NETWORK_STATE
<com.cwillay.coarn.d.e: boolean l()>	Permission:android.permission.ACCESS_NETWORK_STATE
<com.cwillay.FwaunActivity: boolean a(android.content.Context)>	Permission:android.permission.ACCESS_NETWORK_STATE
<com.cwillay.niwin.at: void a(android.content.Context,android.content.Intent,int,com.cwillay.niwin.ao,int,boolean,boolean)>	Permission:android.permission.VIBRATE
<kxyfyh.yk.f.e: void b()>	Permission:android.permission.WAKE_LOCK
<com.tendcloud.tenddata.u: java.lang.String h()>	Permission:android.permission.ACCESS_WIFI_STATE
<com.tendcloud.tenddata.u: java.lang.String o()>	Permission:android.permission.READ_PHONE_STATE
<com.cwillay.tusrck.c.e: com.cwillay.tusrck.c.g k()>	Permission:android.permission.ACCESS_NETWORK_STATE
<hll.kxyfyh.b.ch: boolean b()>	Permission:android.permission.WAKE_LOCK
<hll.kxyfyh.b.ch: public hll.kxyfyh.b.ch()>	Permission:android.permission.WAKE_LOCK
<com.tendcloud.tenddata.u: java.lang.String l()>	Permission:android.permission.READ_PHONE_STATE
<com.cwillay.tusrck.d.c: java.lang.String f(android.content.Context)>	Permission:android.permission.ACCESS_NETWORK_STATE
<com.tendcloud.tenddata.o: boolean a(java.lang.String,byte[],boolean)>	Permission:android.permission.INTERNET
<com.cwillay.niwin.an: protected com.cwillay.niwin.an(android.content.Context)>	Permission:android.permission.READ_PHONE_STATE
<com.cwillay.coarn.NatuIwin: void a()>	Permission:android.permission.WAKE_LOCK
<com.cwillay.coarn.NatuIwin: boolean a(android.content.Context)>	Permission:android.permission.ACCESS_NETWORK_STATE
<com.cwillay.coarn.e.i: public com.cwillay.coarn.e.i(android.content.Context)>	Permission:android.permission.READ_PHONE_STATE
<com.tendcloud.tenddata.u: java.lang.Long[][] u()>	Permission:android.permission.GET_TASKS
<com.cwillay.coarn.NatuIwin: void a(android.app.Service,int)>	Permission:android.permission.WAKE_LOCK
<com.cwillay.coarn.e.g: boolean d(android.content.Context)>	Permission:android.permission.ACCESS_NETWORK_STATE
<com.tendcloud.tenddata.u: boolean b()>	Permission:android.permission.ACCESS_NETWORK_STATE
<com.cwillay.niwin.RTawsnActivity: void a(android.app.Service,int)>	Permission:android.permission.WAKE_LOCK
<com.cwillay.coarn.f.a: java.lang.String p(android.content.Context)>	Permission:android.permission.READ_PHONE_STATE
<com.cwillay.niwin.RTawsnActivity: void a()>	Permission:android.permission.WAKE_LOCK
<com.cwillay.niwin.ewin.i: public com.cwillay.niwin.ewin.i(android.content.Context,boolean,com.cwillay.niwin.ao)>	Permission:android.permission.INTERNET
<com.cwillay.FwaunActivity: void a(android.app.Service,int)>	Permission:android.permission.WAKE_LOCK
<com.cwillay.coarn.g.g: public com.cwillay.coarn.g.g(android.content.Context)>	Permission:android.permission.INTERNET
<com.cwillay.coarn.d.e: com.cwillay.coarn.d.g k()>	Permission:android.permission.ACCESS_NETWORK_STATE
<kxyfyh.a.j: void a(android.content.Context)>	Permission:android.permission.READ_PHONE_STATE
<com.cwillay.tusrck.c.e: boolean l()>	Permission:android.permission.ACCESS_NETWORK_STATE
<com.cwillay.niwin.al: void a(android.content.Context,int,java.lang.String,int,int,android.content.Intent,java.lang.String,int)>	Permission:android.permission.VIBRATE
