<com.overcastgames.android.games.a.d.f: int a(float,float,boolean)>	Permission:android.permission.WAKE_LOCK
<com.umeng.common.b: java.lang.String f(android.content.Context)>	Permission:android.permission.READ_PHONE_STATE
<com.google.ads.b.a: void a()>	Permission:android.permission.WAKE_LOCK
<net.crazymedia.iad.d.s: void a(android.content.Context,int,int,java.lang.String,java.lang.String,java.lang.String,android.content.Intent)>	Permission:android.permission.VIBRATE
<net.crazymedia.iad.d.a: android.graphics.Bitmap a(java.lang.String)>	Permission:android.permission.INTERNET
<com.umeng.common.b: android.location.Location l(android.content.Context)>	Permission:android.permission.ACCESS_FINE_LOCATION
<com.kuguo.ad.r: java.lang.String c(android.content.Context)>	Permission:android.permission.ACCESS_NETWORK_STATE
<net.crazymedia.iad.d.q: java.lang.String d()>	Permission:android.permission.ACCESS_NETWORK_STATE
<com.umeng.common.net.DownloadingService$a: public com.umeng.common.net.DownloadingService$a(com.umeng.common.net.DownloadingService,android.content.Context,com.umeng.common.net.a$a)>	Permission:android.permission.VIBRATE
<com.umeng.common.b: boolean m(android.content.Context)>	Permission:android.permission.ACCESS_NETWORK_STATE
<net.crazymedia.iad.d.q: void a(android.content.Context)>	Permission:android.permission.READ_PHONE_STATE	Permission:android.permission.ACCESS_WIFI_STATE
<com.kuguo.ad.MainReceiver: void onReceive(android.content.Context,android.content.Intent)>	Permission:android.permission.WAKE_LOCK
<com.kuguo.ad.a: java.lang.String a(double,double)>	Permission:android.permission.INTERNET
<com.overcastgames.android.games.a.d.f: void c()>	Permission:android.permission.WAKE_LOCK
<com.kuguo.ad.MainReceiver: void a()>	Permission:android.permission.WAKE_LOCK
<com.google.ads.b.a: void c()>	Permission:android.permission.WAKE_LOCK
<com.overcastgames.android.games.a.d.f: int b()>	Permission:android.permission.WAKE_LOCK
<net.crazymedia.iad.d.s: void a(android.content.Context,int,int,java.lang.String,java.lang.String)>	Permission:android.permission.VIBRATE
<com.kuguo.ad.MainReceiver: void a(android.content.Context,android.content.Intent)>	Permission:android.permission.WAKE_LOCK
<com.google.ads.b.s: void run()>	Permission:android.permission.INTERNET
<net.crazymedia.iad.d.q: int b(android.content.Context)>	Permission:android.permission.ACCESS_NETWORK_STATE
<com.umeng.common.b: java.lang.String[] j(android.content.Context)>	Permission:android.permission.ACCESS_NETWORK_STATE
<com.kuguo.b.b: boolean l()>	Permission:android.permission.ACCESS_NETWORK_STATE
<com.umeng.common.net.d: void handleMessage(android.os.Message)>	Permission:android.permission.VIBRATE
<com.kuguo.ad.i: void a(java.util.Map)>	Permission:android.permission.INTERNET
<com.overcastgames.android.games.a.d.f: int a(float,float)>	Permission:android.permission.WAKE_LOCK
<net.crazymedia.iad.d.t: void b(android.content.Context,java.lang.String)>	Permission:android.permission.INTERNET
<com.kuguo.ad.a: void a(android.content.Context,android.content.Intent,int,com.kuguo.ad.o,int,boolean,boolean)>	Permission:android.permission.VIBRATE
<com.kuguo.ad.ap: protected com.kuguo.ad.ap(android.content.Context)>	Permission:android.permission.READ_PHONE_STATE
<com.google.ads.b.a: void b()>	Permission:android.permission.WAKE_LOCK
<com.overcastgames.android.games.g.d: com.overcastgames.android.games.g.n b(float,float)>	Permission:android.permission.WAKE_LOCK
<com.kuguo.ad.r: void a(android.content.Context,int,java.lang.String,int,int,android.content.Intent,java.lang.String,int)>	Permission:android.permission.VIBRATE
<com.overcastgames.android.games.a.d.f: int a()>	Permission:android.permission.WAKE_LOCK
<com.google.ads.b.t: java.net.HttpURLConnection a(java.net.URL)>	Permission:android.permission.INTERNET
<net.crazymedia.iad.d.s: java.lang.Void a(android.content.Context,net.crazymedia.iad.c.f)>	Permission:android.permission.VIBRATE
<com.kuguo.ad.a: android.location.Location q(android.content.Context)>	Permission:android.permission.ACCESS_FINE_LOCATION	Permission:android.permission.INTERNET
<net.crazymedia.iad.d.n: org.apache.http.Header a(java.lang.String...)>	Permission:android.permission.INTERNET
<com.google.ads.b.c: public com.google.ads.b.c(com.google.ads.aq,com.google.ads.g)>	Permission:android.permission.INTERNET
<com.kuguo.ad.MainReceiver: void a(android.app.Service,int)>	Permission:android.permission.WAKE_LOCK
<com.google.ads.util.AdUtil: java.lang.String d(android.content.Context)>	Permission:android.permission.ACCESS_NETWORK_STATE
<com.google.ads.b.a: void d()>	Permission:android.permission.WAKE_LOCK
<com.kuguo.ad.r: java.lang.String d(android.content.Context)>	Permission:android.permission.ACCESS_NETWORK_STATE
<com.umeng.common.net.i: java.lang.String a(android.content.Context,java.lang.String)>	Permission:android.permission.INTERNET
<com.kuguo.b.b: com.kuguo.b.e k()>	Permission:android.permission.ACCESS_NETWORK_STATE
<com.umeng.analytics.b: java.lang.String a(android.content.Context)>	Permission:android.permission.ACCESS_NETWORK_STATE
<net.crazymedia.iad.d.b: boolean a()>	Permission:android.permission.ACCESS_NETWORK_STATE
<com.google.ads.l: void run()>	Permission:android.permission.INTERNET
<com.kuguo.ad.a: java.lang.String a(android.content.Context)>	Permission:android.permission.READ_PHONE_STATE
