<org.apache.cordova.CordovaWebView: public org.apache.cordova.CordovaWebView(android.content.Context,android.util.AttributeSet)>	Permission:android.permission.INTERNET
<org.apache.cordova.dialogs.Notification: void beep(long)>	Permission:android.permission.WAKE_LOCK
<org.apache.cordova.inappbrowser.InAppBrowser$5: void run()>	Permission:android.permission.INTERNET
<org.apache.cordova.networkinformation.NetworkManager$1: void onReceive(android.content.Context,android.content.Intent)>	Permission:android.permission.ACCESS_NETWORK_STATE
<org.apache.cordova.CordovaWebView: public org.apache.cordova.CordovaWebView(android.content.Context,android.util.AttributeSet,int)>	Permission:android.permission.INTERNET
<org.apache.cordova.media.AudioPlayer: void destroy()>	Permission:android.permission.WAKE_LOCK
<org.apache.cordova.filetransfer.FileTransfer$4: void run()>	Permission:android.permission.INTERNET
<org.apache.cordova.geolocation.GPSListener: void start()>	Permission:android.permission.ACCESS_FINE_LOCATION
<org.apache.cordova.filetransfer.FileTransfer$1: void run()>	Permission:android.permission.INTERNET
<org.apache.cordova.media.AudioPlayer: void startRecording(java.lang.String)>	Permission:android.permission.RECORD_AUDIO
<org.apache.cordova.geolocation.GeoBroker: boolean execute(java.lang.String,org.json.JSONArray,org.apache.cordova.CallbackContext)throwsorg.json.JSONException>	Permission:android.permission.ACCESS_FINE_LOCATION
<org.apache.cordova.media.AudioPlayer: void onPrepared(android.media.MediaPlayer)>	Permission:android.permission.WAKE_LOCK
<org.apache.cordova.media.AudioPlayer: void stopPlaying()>	Permission:android.permission.WAKE_LOCK
<org.apache.cordova.media.AudioPlayer: void pausePlaying()>	Permission:android.permission.WAKE_LOCK
<org.apache.cordova.geolocation.CordovaLocationListener: void start()>	Permission:android.permission.ACCESS_FINE_LOCATION
<org.apache.cordova.CordovaWebView: public org.apache.cordova.CordovaWebView(android.content.Context,android.util.AttributeSet,int,boolean)>	Permission:android.permission.INTERNET
<org.apache.cordova.vibration.Vibration: void vibrate(long)>	Permission:android.permission.WAKE_LOCK
<org.apache.cordova.media.AudioPlayer: boolean onError(android.media.MediaPlayer,int,int)>	Permission:android.permission.WAKE_LOCK
<org.apache.cordova.media.AudioPlayer: void startPlaying(java.lang.String)>	Permission:android.permission.WAKE_LOCK
<org.apache.cordova.CordovaWebView: public org.apache.cordova.CordovaWebView(android.content.Context)>	Permission:android.permission.INTERNET
<org.apache.cordova.networkinformation.NetworkManager: boolean execute(java.lang.String,org.json.JSONArray,org.apache.cordova.CallbackContext)>	Permission:android.permission.ACCESS_NETWORK_STATE
<org.apache.cordova.contacts.ContactAccessorSdk5: java.lang.String save(org.json.JSONObject)>	Permission:android.permission.GET_ACCOUNTS
