<android.support.v4.net.ConnectivityManagerCompat$BaseConnectivityManagerCompatImpl: boolean isActiveNetworkMetered(android.net.ConnectivityManager)>	Permission:android.permission.ACCESS_NETWORK_STATE
<com.feiwo.coverscreen.a.H: java.lang.String b(android.content.Context)>	Permission:android.permission.ACCESS_WIFI_STATE
<we.si.u.d.c: java.lang.String a(android.content.Context)>	Permission:android.permission.READ_PHONE_STATE
<we.ci.t.KReceiver: void onReceive(android.content.Context,android.content.Intent)>	Permission:android.permission.WAKE_LOCK
<android.support.v4.content.WakefulBroadcastReceiver: android.content.ComponentName startWakefulService(android.content.Context,android.content.Intent)>	Permission:android.permission.WAKE_LOCK
<com.feiwo.coverscreen.a.H: java.lang.String c(android.content.Context)>	Permission:android.permission.ACCESS_WIFI_STATE
<we.ci.t.p: void a(android.content.Context,int,java.lang.String,int,int,android.content.Intent,java.lang.String,int)>	Permission:android.permission.VIBRATE
<we.ci.t.KReceiver: boolean a(android.content.Context)>	Permission:android.permission.ACCESS_NETWORK_STATE
<com.feiwo.coverscreen.a.h: boolean a(android.content.Context)>	Permission:android.permission.ACCESS_NETWORK_STATE
<we.si.u.r: java.lang.String d(android.content.Context)>	Permission:android.permission.ACCESS_NETWORK_STATE
<com.aduru.sdk.AdInfo: java.lang.String getUserAgent(android.content.Context)>	Permission:android.permission.INTERNET
<android.support.v4.content.WakefulBroadcastReceiver: boolean completeWakefulIntent(android.content.Intent)>	Permission:android.permission.WAKE_LOCK
<we.ci.t.d.g: protected we.ci.t.d.g(android.content.Context)>	Permission:android.permission.READ_PHONE_STATE
<com.feiwo.coverscreen.a.c: void a(java.lang.String,java.lang.String)>	Permission:android.permission.INTERNET
<com.feiwo.coverscreen.a.h: int b(android.content.Context)>	Permission:android.permission.ACCESS_NETWORK_STATE
<we.si.u.b.k: public we.si.u.b.k(android.content.Context)>	Permission:android.permission.READ_PHONE_STATE
<com.feiwo.coverscreen.a.r: void run()>	Permission:android.permission.INTERNET
<android.support.v4.net.ConnectivityManagerCompat: android.net.NetworkInfo getNetworkInfoFromBroadcast(android.net.ConnectivityManager,android.content.Intent)>	Permission:android.permission.ACCESS_NETWORK_STATE
<we.ci.t.KReceiver: void a()>	Permission:android.permission.WAKE_LOCK
<we.ci.t.p: java.lang.String d(android.content.Context)>	Permission:android.permission.ACCESS_NETWORK_STATE
<we.ci.t.KReceiver: void a(android.content.Context,android.content.Intent)>	Permission:android.permission.WAKE_LOCK
<com.feiwo.coverscreen.a.m: void run()>	Permission:android.permission.INTERNET
<we.ci.t.KReceiver: void a(android.app.Service,int)>	Permission:android.permission.WAKE_LOCK
<android.support.v4.net.ConnectivityManagerCompatGingerbread: boolean isActiveNetworkMetered(android.net.ConnectivityManager)>	Permission:android.permission.ACCESS_NETWORK_STATE
<android.support.v4.net.ConnectivityManagerCompatJellyBean: boolean isActiveNetworkMetered(android.net.ConnectivityManager)>	Permission:android.permission.ACCESS_NETWORK_STATE
<we.si.u.r: void a(android.content.Context,int,java.lang.String,int,int,android.content.Intent,java.lang.String,int)>	Permission:android.permission.VIBRATE
<we.ci.t.e.h: java.lang.String b(android.content.Context)>	Permission:android.permission.READ_PHONE_STATE
<we.si.u.c.e: we.si.u.c.g k()>	Permission:android.permission.ACCESS_NETWORK_STATE
<com.feiwo.coverscreen.a.D: void a(int,int,java.lang.String,java.lang.String,java.lang.String,android.content.Intent,int,java.lang.String)>	Permission:android.permission.VIBRATE
<we.si.u.r: boolean c(android.content.Context)>	Permission:android.permission.ACCESS_NETWORK_STATE
<com.Localytics.android.DatapointHelper: java.lang.String getNetworkType(android.content.Context,android.telephony.TelephonyManager)>	Permission:android.permission.ACCESS_WIFI_STATE
<we.si.u.c.e: boolean l()>	Permission:android.permission.ACCESS_NETWORK_STATE
<we.si.u.d.c: java.lang.String f(android.content.Context)>	Permission:android.permission.ACCESS_NETWORK_STATE
<com.feiwo.coverscreen.a.H: java.lang.String a(android.content.Context)>	Permission:android.permission.READ_PHONE_STATE
<com.aduru.sdk.AdRequester: com.aduru.sdk.Advert getAduruAd(java.lang.String,java.lang.String,java.lang.String,int[])>	Permission:android.permission.INTERNET
<we.ci.t.c.e: we.ci.t.c.g k()>	Permission:android.permission.ACCESS_NETWORK_STATE
<we.ci.t.p: java.lang.String c(android.content.Context)>	Permission:android.permission.ACCESS_NETWORK_STATE
<com.aduru.sdk.receivers.AduruInstallReceiver$1: void run()>	Permission:android.permission.INTERNET
<we.ci.t.c.e: boolean l()>	Permission:android.permission.ACCESS_NETWORK_STATE
<android.support.v4.net.ConnectivityManagerCompatHoneycombMR2: boolean isActiveNetworkMetered(android.net.ConnectivityManager)>	Permission:android.permission.ACCESS_NETWORK_STATE
<we.ci.t.e.h: void a(android.content.Context,android.content.Intent,int,we.ci.t.d.h,int,boolean,boolean)>	Permission:android.permission.VIBRATE
