<android.support.v4.net.ConnectivityManagerCompat$BaseConnectivityManagerCompatImpl: boolean isActiveNetworkMetered(android.net.ConnectivityManager)>	Permission:android.permission.ACCESS_NETWORK_STATE
<com.google.android.gms.internal.cy: boolean onCreateWindow(android.webkit.WebView,boolean,boolean,android.os.Message)>	Permission:android.permission.INTERNET
<com.google.android.gms.maps.model.UrlTileProvider: com.google.android.gms.maps.model.Tile getTile(int,int,int)>	Permission:android.permission.INTERNET
<com.adsdk.sdk.Util: java.lang.String getConnectionType(android.content.Context)>	Permission:android.permission.ACCESS_NETWORK_STATE
<android.support.v4.content.WakefulBroadcastReceiver: android.content.ComponentName startWakefulService(android.content.Context,android.content.Intent)>	Permission:android.permission.WAKE_LOCK
<android.support.v4.net.ConnectivityManagerCompatGingerbread: boolean isActiveNetworkMetered(android.net.ConnectivityManager)>	Permission:android.permission.ACCESS_NETWORK_STATE
<com.startapp.android.publish.f.o: boolean a(android.content.Context)>	Permission:android.permission.ACCESS_NETWORK_STATE
<com.google.tagmanager.SimpleNetworkDispatcher: boolean okToDispatch()>	Permission:android.permission.ACCESS_NETWORK_STATE
<com.google.tagmanager.HttpUrlConnectionNetworkClient: java.net.HttpURLConnection getUrlConnection(java.lang.String)throwsjava.io.IOException>	Permission:android.permission.INTERNET
<android.support.v4.content.WakefulBroadcastReceiver: boolean completeWakefulIntent(android.content.Intent)>	Permission:android.permission.WAKE_LOCK
<com.startapp.android.publish.c.b: void a(boolean)>	Permission:android.permission.INTERNET
<com.google.android.gms.internal.bo: void af()>	Permission:android.permission.WAKE_LOCK
<com.adsdk.sdk.Util: android.location.Location getLocation(android.content.Context)>	Permission:android.permission.ACCESS_FINE_LOCATION
<com.google.android.gms.internal.bo: void play()>	Permission:android.permission.WAKE_LOCK
<com.adsdk.sdk.Util: boolean isNetworkAvailable(android.content.Context)>	Permission:android.permission.ACCESS_NETWORK_STATE
<com.startapp.android.publish.slider.b$2:  com.startapp.android.publish.slider.b$2(com.startapp.android.publish.slider.b,android.content.Context)>	Permission:android.permission.INTERNET
<com.google.analytics.tracking.android.SimpleNetworkDispatcher: boolean okToDispatch()>	Permission:android.permission.ACCESS_NETWORK_STATE
<com.adsdk.sdk.video.TrackerService$1: void run()>	Permission:android.permission.INTERNET
<com.startapp.android.publish.AppWallDelegateActivity: void onCreate(android.os.Bundle)>	Permission:android.permission.INTERNET
<com.adsdk.sdk.video.RichMediaActivity: void onHideCustomView()>	Permission:android.permission.WAKE_LOCK
<com.startapp.android.publish.list3d.List3DActivity$2: void onItemClick(android.widget.AdapterView<?>,android.view.View,int,long)>	Permission:android.permission.INTERNET
<com.google.tagmanager.HttpUrlConnectionNetworkClient: void sendPostRequest(java.lang.String,byte[])throwsjava.io.IOException>	Permission:android.permission.INTERNET
<com.google.android.gms.auth.GoogleAuthUtil: void invalidateToken(android.content.Context,java.lang.String)>	Permission:android.permission.MANAGE_ACCOUNTS
<android.support.v4.net.ConnectivityManagerCompat: android.net.NetworkInfo getNetworkInfoFromBroadcast(android.net.ConnectivityManager,android.content.Intent)>	Permission:android.permission.ACCESS_NETWORK_STATE
<com.adsdk.sdk.video.SDKVideoView: void pause()>	Permission:android.permission.WAKE_LOCK
<com.adsdk.sdk.nativeads.RequestNativeAd: com.adsdk.sdk.nativeads.NativeAd sendRequest(com.adsdk.sdk.nativeads.NativeAdRequest)throwscom.adsdk.sdk.RequestException>	Permission:android.permission.INTERNET
<com.google.android.gms.internal.cr: void ai()>	Permission:android.permission.INTERNET
<com.startapp.android.publish.f.i: java.lang.String a(android.content.Context)>	Permission:android.permission.ACCESS_NETWORK_STATE
<com.startapp.android.publish.f.o: void a(android.content.Context,java.lang.String,int,java.lang.Runnable)>	Permission:android.permission.INTERNET
<com.adsdk.sdk.video.WebFrame: public com.adsdk.sdk.video.WebFrame(android.app.Activity,boolean,boolean,boolean)>	Permission:android.permission.INTERNET
<com.adsdk.sdk.video.SDKVideoView: void stopPlayback()>	Permission:android.permission.WAKE_LOCK
<android.support.v4.net.ConnectivityManagerCompatJellyBean: boolean isActiveNetworkMetered(android.net.ConnectivityManager)>	Permission:android.permission.ACCESS_NETWORK_STATE
<com.google.android.gms.internal.bo: void destroy()>	Permission:android.permission.WAKE_LOCK
<com.google.android.gms.internal.ce: com.google.android.gms.internal.cb a(android.content.Context,java.lang.String,java.lang.String)>	Permission:android.permission.INTERNET
<com.adsdk.sdk.Util: java.lang.String getTelephonyDeviceId(android.content.Context)>	Permission:android.permission.READ_PHONE_STATE
<com.adsdk.sdk.mraid.BaseWebView: public com.adsdk.sdk.mraid.BaseWebView(android.content.Context)>	Permission:android.permission.INTERNET
<com.adsdk.sdk.video.RichMediaActivity: void onShowCustomView(android.view.View,android.webkit.WebChromeClient$CustomViewCallback)>	Permission:android.permission.WAKE_LOCK
<com.adsdk.sdk.video.WebFrame$LoadUrlTask: java.lang.String doInBackground(java.lang.String...)>	Permission:android.permission.INTERNET
<com.startapp.android.publish.adinformation.a: void onClick(android.view.View)>	Permission:android.permission.INTERNET
<com.startapp.android.publish.b.c: void k()>	Permission:android.permission.INTERNET
<com.startapp.android.publish.f.e: android.graphics.Bitmap a(java.lang.String)>	Permission:android.permission.INTERNET
<com.adsdk.sdk.banner.BannerAdView$1:  com.adsdk.sdk.banner.BannerAdView$1(com.adsdk.sdk.banner.BannerAdView,android.content.Context)>	Permission:android.permission.INTERNET
<com.startapp.android.publish.f.i: java.lang.String b(android.content.Context)>	Permission:android.permission.ACCESS_NETWORK_STATE	Permission:android.permission.ACCESS_WIFI_STATE
<com.adsdk.sdk.video.SDKVideoView: void start()>	Permission:android.permission.WAKE_LOCK
<com.google.android.gms.internal.bo: void pause()>	Permission:android.permission.WAKE_LOCK
<com.google.ads.mediation.jsadapter.JavascriptAdapter: void requestBannerAd(com.google.ads.mediation.MediationBannerListener,android.app.Activity,com.google.ads.mediation.jsadapter.JavascriptServerParameters,com.google.ads.AdSize,com.google.ads.mediation.MediationAdRequest,com.google.ads.mediation.EmptyNetworkExtras)>	Permission:android.permission.INTERNET
<com.startapp.android.publish.Ad: boolean load(com.startapp.android.publish.model.AdPreferences,com.startapp.android.publish.AdEventListener,boolean)>	Permission:android.permission.INTERNET
<com.adsdk.sdk.RequestAd: T sendRequest(com.adsdk.sdk.AdRequest)throwscom.adsdk.sdk.RequestException>	Permission:android.permission.INTERNET
<android.support.v4.net.ConnectivityManagerCompatHoneycombMR2: boolean isActiveNetworkMetered(android.net.ConnectivityManager)>	Permission:android.permission.ACCESS_NETWORK_STATE
