<Banks.CSound: void stop()>	Permission:android.permission.WAKE_LOCK
<Banks.CSound: void release()>	Permission:android.permission.WAKE_LOCK
<com.google.ads.g: void b()>	Permission:android.permission.WAKE_LOCK
<com.google.ads.g: void d()>	Permission:android.permission.WAKE_LOCK
<Banks.CSound: void onCompletion(android.media.MediaPlayer)>	Permission:android.permission.WAKE_LOCK
<Banks.CMusic: void start()>	Permission:android.permission.WAKE_LOCK
<Extensions.CRunAndroid: boolean condition(int,Conditions.CCndExtension)>	Permission:android.permission.BLUETOOTH
<Banks.CMusic: void pause()>	Permission:android.permission.WAKE_LOCK
<com.google.ads.w: void run()>	Permission:android.permission.INTERNET
<Application.CRunApp: Application.CRunApp$HFile openHFile(java.lang.String)>	Permission:android.permission.INTERNET
<com.google.ads.b: void run()>	Permission:android.permission.INTERNET
<Runtime.CrashReporter$1: java.lang.String getValue()>	Permission:android.permission.GET_ACCOUNTS
<com.google.ads.g: void a()>	Permission:android.permission.WAKE_LOCK
<Banks.CSound: void start()>	Permission:android.permission.WAKE_LOCK
<com.google.ads.h: public com.google.ads.h(android.content.Context,com.google.ads.AdSize)>	Permission:android.permission.INTERNET
<Banks.CMusic: void stop()>	Permission:android.permission.WAKE_LOCK
<Banks.CMusic: void release()>	Permission:android.permission.WAKE_LOCK
<Extensions.CRunAndroid: void action(int,Actions.CActExtension)>	Permission:android.permission.WAKE_LOCK
<Banks.CMusic: void onCompletion(android.media.MediaPlayer)>	Permission:android.permission.WAKE_LOCK
<Extensions.CRunAndroid: android.net.NetworkInfo getActiveNetworkInfo()>	Permission:android.permission.ACCESS_NETWORK_STATE
<Runtime.CrashReporter: void uncaughtException(java.lang.Thread,java.lang.Throwable)>	Permission:android.permission.INTERNET
<Banks.CSound: void pause()>	Permission:android.permission.WAKE_LOCK
<Extensions.CRunAndroid: Expressions.CValue expression(int)>	Permission:android.permission.READ_PHONE_STATE
<com.google.ads.util.AdUtil: java.lang.String d(android.content.Context)>	Permission:android.permission.ACCESS_NETWORK_STATE
<com.google.ads.g: void c()>	Permission:android.permission.WAKE_LOCK
