<gnu.text.URIPath: boolean exists()>	Permission:android.permission.INTERNET
<com.google.appinventor.components.runtime.Pedometer: public com.google.appinventor.components.runtime.Pedometer(com.google.appinventor.components.runtime.ComponentContainer)>	Permission:android.permission.ACCESS_FINE_LOCATION
<org.acra.util.ReportUtils: java.lang.String getDeviceId(android.content.Context)>	Permission:android.permission.READ_PHONE_STATE
<com.google.appinventor.components.runtime.util.GingerbreadUtil: void enableNFCWriteMode(android.app.Activity,android.nfc.NfcAdapter,java.lang.String)>	Permission:android.permission.NFC
<com.google.appinventor.components.runtime.util.ClientLoginHelper: java.lang.String getAuthToken()throwsorg.apache.http.client.ClientProtocolException>	Permission:android.permission.MANAGE_ACCOUNTS
<com.google.appinventor.components.runtime.util.AccountChooser: android.accounts.Account findAccount()>	Permission:android.permission.GET_ACCOUNTS
<com.google.appinventor.components.runtime.util.FullScreenVideoUtil$4: void run()>	Permission:android.permission.WAKE_LOCK
<com.google.appinventor.components.runtime.PhoneStatus: java.lang.String GetWifiIpAddress()>	Permission:android.permission.ACCESS_WIFI_STATE
<gnu.text.URLPath: java.io.InputStream openInputStream(java.net.URL)throwsjava.io.IOException>	Permission:android.permission.INTERNET
<com.google.appinventor.components.runtime.LocationSensor: void RefreshProvider()>	Permission:android.permission.ACCESS_FINE_LOCATION
<com.google.appinventor.components.runtime.Player: void Source(java.lang.String)>	Permission:android.permission.WAKE_LOCK
<com.google.appinventor.components.runtime.util.GingerbreadUtil: boolean writeNFCTag(android.nfc.NdefMessage,android.nfc.Tag)>	Permission:android.permission.NFC
<gnu.bytecode.ArrayClassLoader: java.net.URL findResource(java.lang.String)>	Permission:android.permission.INTERNET
<com.google.appinventor.components.runtime.util.AppInvHTTPD$1: void run()>	Permission:android.permission.INTERNET
<com.google.common.io.Resources$UrlByteSource: java.io.InputStream openStream()throwsjava.io.IOException>	Permission:android.permission.INTERNET
<com.google.appinventor.components.runtime.Player: void Stop()>	Permission:android.permission.WAKE_LOCK
<gnu.text.URLPath: java.io.OutputStream openOutputStream(java.net.URL)throwsjava.io.IOException>	Permission:android.permission.INTERNET
<gnu.expr.ModuleInfo: boolean checkCurrent(gnu.expr.ModuleManager,long)>	Permission:android.permission.INTERNET
<com.google.api.client.http.javanet.NetHttpRequest:  com.google.api.client.http.javanet.NetHttpRequest(java.lang.String,java.lang.String)throwsjava.io.IOException>	Permission:android.permission.INTERNET
<com.google.appinventor.components.runtime.Sound: void Vibrate(int)>	Permission:android.permission.WAKE_LOCK
<com.google.api.client.googleapis.extensions.android2.auth.GoogleAccountManager: void invalidateAuthToken(java.lang.String)>	Permission:android.permission.MANAGE_ACCOUNTS
<com.google.appinventor.components.runtime.PhoneStatus: boolean isConnected()>	Permission:android.permission.ACCESS_NETWORK_STATE
<gnu.bytecode.dump: void main(java.lang.String[])>	Permission:android.permission.INTERNET
<com.google.appinventor.components.runtime.Player: void Vibrate(long)>	Permission:android.permission.WAKE_LOCK
<com.google.appinventor.components.runtime.util.FullScreenVideoUtil: android.os.Bundle performAction(int,com.google.appinventor.components.runtime.VideoPlayer,java.lang.Object)>	Permission:android.permission.WAKE_LOCK
<com.google.appinventor.components.runtime.util.ClientLoginHelper: org.apache.http.HttpResponse execute(org.apache.http.client.methods.HttpUriRequest)throwsorg.apache.http.client.ClientProtocolException,java.io.IOException>	Permission:android.permission.MANAGE_ACCOUNTS
<com.google.appinventor.components.runtime.Player: void Pause()>	Permission:android.permission.WAKE_LOCK
<com.google.appinventor.components.runtime.WebViewer: public com.google.appinventor.components.runtime.WebViewer(com.google.appinventor.components.runtime.ComponentContainer)>	Permission:android.permission.INTERNET
<com.google.appinventor.components.runtime.util.NanoHTTPD: public com.google.appinventor.components.runtime.util.NanoHTTPD(int,java.io.File)throwsjava.io.IOException>	Permission:android.permission.INTERNET
<com.google.appinventor.components.runtime.util.FileUtil: java.lang.String downloadUrlToFile(java.lang.String,java.lang.String)throwsjava.io.IOException>	Permission:android.permission.INTERNET
<gnu.text.URLPath: long getLastModified(java.net.URL)>	Permission:android.permission.INTERNET
<com.google.api.client.http.javanet.NetHttpRequest: com.google.api.client.http.LowLevelHttpResponse execute()throwsjava.io.IOException>	Permission:android.permission.INTERNET
<com.google.api.client.googleapis.extensions.android2.auth.GoogleAccountManager: android.accounts.Account[] getAccounts()>	Permission:android.permission.GET_ACCOUNTS
<com.google.appinventor.components.runtime.Texting$GoogleVoiceUtil: java.lang.String get(java.lang.String)throwsjava.io.IOException>	Permission:android.permission.INTERNET
<com.google.appinventor.components.runtime.Player: void Start()>	Permission:android.permission.WAKE_LOCK
<com.google.appinventor.components.runtime.SoundRecorder$RecordingController:  com.google.appinventor.components.runtime.SoundRecorder$RecordingController(com.google.appinventor.components.runtime.SoundRecorder)throwsjava.io.IOException>	Permission:android.permission.RECORD_AUDIO
<com.google.appinventor.components.runtime.util.MediaUtil: void loadVideoView(android.widget.VideoView,com.google.appinventor.components.runtime.Form,java.lang.String)throwsjava.io.IOException>	Permission:android.permission.WAKE_LOCK
<gnu.text.ResourceStreamHandler: java.net.URLConnection openConnection(java.net.URL)throwsjava.io.IOException>	Permission:android.permission.INTERNET
<com.google.appinventor.components.runtime.Pedometer: void UseGPS(boolean)>	Permission:android.permission.ACCESS_FINE_LOCATION
<gnu.text.URLPath: int getContentLength(java.net.URL)>	Permission:android.permission.INTERNET
<com.google.appinventor.components.runtime.util.ReplCommController$REPLServerController$1: void run()>	Permission:android.permission.INTERNET
<com.google.appinventor.components.runtime.WebViewActivity: void onCreate(android.os.Bundle)>	Permission:android.permission.INTERNET
<kawa.repl: int processArgs(java.lang.String[],int,int)>	Permission:android.permission.INTERNET
<com.google.appinventor.components.runtime.util.GingerbreadUtil: void disableNFCAdapter(android.app.Activity,android.nfc.NfcAdapter)>	Permission:android.permission.NFC
<com.google.appinventor.components.runtime.util.FullScreenVideoUtil: void onPrepared(android.media.MediaPlayer)>	Permission:android.permission.WAKE_LOCK
